1,1,1,1,1,1,1,1,1,1,1,1
1,2,2,2,2,2,2,2,2,2,2,1
1,2,5,0,0,0,0,0,0,0,2,1
1,2,5,0,0,0,0,0,0,0,2,1
1,2,5,3,0,0,8,0,0,0,2,1
1,2,5,0,0,0,0,0,0,0,2,1
1,2,5,5,5,0,0,0,0,0,2,1
1,2,0,0,0,0,4,5,5,5,2,1
1,2,0,0,0,0,0,0,0,0,2,1
1,2,0,0,0,0,0,0,0,0,2,1
1,2,2,2,2,2,2,2,2,2,2,1
1,1,1,1,1,1,1,1,1,1,1,1