1,1,1,1,1,1,1,1,1,1
1,2,2,2,2,2,2,2,2,1
1,2,6,6,6,6,6,6,2,1
1,2,6,0,0,0,0,6,2,1
1,2,6,0,0,0,0,6,2,1
1,2,6,0,0,0,0,6,2,1
1,2,6,0,0,0,0,6,2,1
1,2,6,0,0,0,0,6,2,1
1,2,6,0,0,0,0,6,2,1
1,2,6,0,5,0,0,6,2,1
1,2,6,0,0,0,0,6,2,1
1,2,6,0,3,0,0,6,2,1
1,2,2,2,2,2,2,2,2,1
1,1,1,1,1,1,1,1,1,1