1,1,1,1,1,1,1,1,1,1
1,2,2,2,2,2,2,2,2,1
1,2,5,5,5,5,5,5,2,1
1,2,5,0,0,0,0,5,2,1
1,2,5,0,0,0,0,5,2,1
1,2,5,0,0,0,0,5,2,1
1,2,5,0,0,0,0,5,2,1
1,2,5,0,0,0,0,5,2,1
1,2,5,0,0,0,0,5,2,1
1,2,5,0,6,0,0,5,2,1
1,2,5,0,0,0,0,5,2,1
1,2,5,0,3,0,0,5,2,1
1,2,2,2,2,2,2,2,2,1
1,1,1,1,1,1,1,1,1,1