1,1,1,1,1,1,1,1,1,1
1,2,2,2,2,2,2,2,2,1
1,2,3,0,0,0,0,0,2,1
1,2,0,0,5,0,0,6,2,1
1,2,0,0,0,0,0,0,2,1
1,2,0,0,4,0,0,0,2,1
1,2,4,0,0,0,0,4,2,1
1,2,3,0,0,0,0,0,2,1
1,2,2,2,2,2,2,2,2,1
1,1,1,1,1,1,1,1,1,1