1,1,1,1,1,1,1,1,1,1
1,2,2,2,2,2,2,2,2,1
1,2,0,2,5,2,0,6,2,1
1,2,0,2,0,2,0,0,2,1
1,2,0,0,0,0,0,0,2,1
1,2,0,0,0,0,0,0,2,1
1,2,0,0,0,0,0,0,2,1
1,2,3,0,0,0,0,0,2,1
1,2,2,2,2,2,2,2,2,1
1,1,1,1,1,1,1,1,1,1